NO ./textures/n.xpm
SO ./textures/s.xpm
WE ./textures/w.xpm
EA ./textures/e.xpm

F 80,160,90
C 135,206,235

11111111111111111111111111111
10000000000000010000000000001
10000000000000010000000000001
10000000000000010000001000001
1000000E000000000000000000001
10000000000000000100000000001
10000000000000000100000000001
11111111111111111111111111111
